SO /Users/moait-la/Downloads/42-Cube3D-chahlaoui/assets/textures/so.png
WE /Users/moait-la/Downloads/42-Cube3D-chahlaoui/assets/textures/we.png
NO /Users/moait-la/Downloads/42-Cube3D-chahlaoui/assets/textures/no.png
EA /Users/moait-la/Downloads/42-Cube3D-chahlaoui/assets/textures/ea.png

F 0,0,0
C 53,81,92

        1111111111111111111111111
        1000000000110000000000001
        1011000001110000000000001
111111111001000000000000000000001111111111111111111111111111111111
111111111011000001110000000000000000000000011000001110000000000001
100000000011000001110111100111111111111111111111111111111111111111
11110111111111011100000010001
11110111111111011111110010001
11000000110101011111010011001111
10000000000000000000000000011001
10000000000000000010100000001111111
110000011101010000001111000001111
111101111110101100000000000000N1
111111111111111111111111111111111