NO              assets/textures/n.png
SO assets/textures/s.png
WE assets/textures/w.png
WE assets/textures/w.png
EA assets/textures/e.png
F 0,0,0

C 53,81,92

        1111111111111111111111111
        1000000000110000000000001
        1011000001110000000000001
111111111001000000000000000000001111111111111111111111111111111111
111111111011000001110000000000001111111111011000001110000000000001
100000000011000001110111100111111111111111111111111111111111111111
11110111111111011100000010001
11110111111111011101010010001
11000000110101011100000010001
10000000000000001100000010001
10000000000000001101010010001
11000001110101011111011110N0111
11110111 1110101 101111010001
11111111 1111111 111111111111
