SO /Users/moait-la/Downloads/last/assets/textures/so.png
WE /Users/moait-la/Downloads/last/assets/textures/we.png
NO /Users/moait-la/Downloads/last/assets/textures/no.png
EA /Users/moait-la/Downloads/last/assets/textures/ea.png
F 0,0,0
C 53,81,92

111111111111111111111111111111111111111111111111111111111111111111
1000000000000000000000000000000000000000000000000000000000000000N1
101111111111111111111111111111111111111111111111111111111111111101
100000000000000000000000000000000000000000000000000000000000000001
101111111111111111111111111111111111111111111111111111111111111101
100000000000000000000000000000000000000000000000000000000000000001
111111111111111111111111111111111111111111111111111111111111111111
100000000000000000000000000000000000000000000000000000000000000001
101111111111111111111111111111111111111111111111111111111111111101
100000000000000000000000000000000000000000000000000000000000000001
111111111111111111111111111111111111111111111111111111111111111111
100000000000000000000000000000000000000000000000000000000000000001
111111111111111111111111111111111111111111111111111111111111111111
111111111111111111111111111111111111111111111111111111111111111111
