SO /Users/moait-la/Downloads/last/assets/textures/so.png
WE /Users/moait-la/Downloads/last/assets/textures/we.png
NO /Users/moait-la/Downloads/last/assets/textures/no.png
EA /Users/moait-la/Downloads/last/assets/textures/ea.png
C 42,97,110
F 13,29,48

11111111
10001101
1N000001
10001111
10011001
11111111