NO              asserrrrrrrrrrrrrrrrrts/textures/n.png
SO assrrrrrrrrrrrrrrrets/textures/s.png
WE assets/textures/w.png
WE assets/textures/w.png
EA assets/textures/e.png
F 0,0,0

C 53,81,92

        1111111111111111111111111
        1000000000110000000000001
        1011000001110000000000001
111111111001000000000000000000001111111111111111111111111111111111
111111111011000001110000000000000000000000011000001110000000000001
100000000011000001110111100111111111111111111111111111111111111111
11110111111111011100000010001111111111111111111111111111111
11110111111111011111110010001111111111111111111111111111111
11000000110101011111010011001111111111111111111111111111111111
10000000000000000000000000011001111111111111111111111111111111
10000000000000000010100000001111111111111111111111111111111111111
110000011101010000001111000000011111111111111111111111111111111
1111011111101011000000000000000N1111111111111111111111111111111
111111111111111111111111111111111111111111111111111111111111111
